www.akakom.ac.id	   pmtud-success
www.akprind.ac.id	   pmtud-success
www.amikom.ac.id	   pmtud-success
www.asia.ac.id	   pmtud-success
www.asmi.ac.id	   pmtud-toosmall
www.atmajaya.ac.id	   pmtud-success
www.bakrie.ac.id	   pmtud-success
www.binadarma.ac.id	   pmtud-success
www.binus.ac.id	   pmtud-toosmall
www.borneo.ac.id	   pmtud-success
www.budiluhur.ac.id	   pmtud-success
www.bunghatta.ac.id	   pmtud-success
www.ciputra.ac.id	   pmtud-toosmall
www.darmajaya.ac.id	   pmtud-success
www.dharmawangsa.ac.id	   pmtud-toosmall
www.dinus.ac.id	   pmtud-success
www.eepis-its.edu	   pmtud-success
www.esaunggul.ac.id	   pmtud-success
www.fhwidyamataram.ac.id	   pmtud-toosmall
www.ft-untirta.ac.id	   pmtud-success
www.gunadarma.ac.id	   pmtud-success
www.hangtuah.ac.id	   pmtud-success
www.iba.ac.id	   pmtud-fail
www.ibii.ac.id	   pmtud-success
www.igm.ac.id	   pmtud-toosmall
www.iisip.ac.id	   pmtud-success
www.ikj.ac.id	   pmtud-success
www.imtelkom.ac.id	   pmtud-success
www.ipb.ac.id	   pmtud-success
www.ipmimba.ac.id	   pmtud-toosmall
www.isi-dps.ac.id	   pmtud-success
www.isi.ac.id	   pmtud-toosmall
www.ista.ac.id	   pmtud-success
www.itb.ac.id	   pmtud-success
www.itenas.ac.id	   pmtud-success
www.ithb.ac.id	   tcp-noconn
www.iti.ac.id	   pmtud-nodata
www.itm.ac.id	   pmtud-success
www.itn.ac.id	   pmtud-success
www.its.ac.id	   pmtud-success
www.ittelkom.ac.id	   pmtud-success
www.jagakarsa.ac.id	   pmtud-nodf
www.jak-stik.ac.id	   pmtud-success
www.janabadra.ac.id	   pmtud-success
www.jayabaya.ac.id	   pmtud-success
www.likmi.ac.id	   pmtud-success
www.lpp.ac.id	   pmtud-success
www.machung.ac.id	   pmtud-cleardf
www.maranatha.edu	   pmtud-fail
www.mercubuana-yogya.ac.id	   pmtud-toosmall
www.mercubuana.ac.id	   pmtud-success
www.moestopo.ac.id	   pmtud-success
www.mputantular.ac.id	   pmtud-success
www.narotama.ac.id	   pmtud-success
www.nommensen.org	   pmtud-nodf
www.nusantara.ac.id	   pmtud-success
www.paramadina.ac.id	   pmtud-success
www.pasim.ac.id	   tcp-noconn
www.perbanas.ac.id	   pmtud-success
www.perbanasinstitute.ac.id	   pmtud-success
www.petra.ac.id	   pmtud-success
www.pidel.org	   pmtud-success
www.pmbs.ac.id	   pmtud-success
www.pmy.ac.id	   pmtud-toosmall
www.pnb.ac.id	   tcp-noconn
www.pnl.ac.id	   pmtud-toosmall
www.polban.ac.id	   pmtud-success
www.poliban.ac.id	   pmtud-success
www.polimdo.ac.id	   pmtud-success
www.polines.ac.id	   pmtud-success
www.polinpdg.ac.id	   pmtud-success
www.poliseni.ac.id	   pmtud-success
www.politekniktelkom.ac.id	   pmtud-toosmall
www.poliupg.ac.id	   pmtud-toosmall
www.polman-bandung.ac.id	   pmtud-toosmall
www.polman-timah.ac.id	   pmtud-toosmall
www.polnes.ac.id	   pmtud-success
www.polsri.ac.id	   pmtud-success
www.poltek-malang.ac.id	   pmtud-success
www.polteklampung.ac.id	   pmtud-success
www.poltekpos.ac.id	   pmtud-success
www.polteksurabaya.ac.id	   pmtud-success
www.ppm-manajemen.ac.id	   pmtud-success
www.president.ac.id	   pmtud-success
www.puterabatam.ac.id	   pmtud-success
www.respati.ac.id	   pmtud-success
www.satyagama.ac.id	   pmtud-success
www.setiabudi.ac.id	   pmtud-toosmall
www.sgu.ac.id	   pmtud-success
www.stie-mce.ac.id	   pmtud-success
www.stieken.ac.id	   pmtud-success
www.stieykpn.ac.id	   pmtud-success
www.stikesbanten.ac.id	   pmtud-success
www.stiki.ac.id	   pmtud-fail
www.stikom-bali.ac.id	   pmtud-success
www.stikom.edu	   pmtud-success
www.stimra.ac.id	   pmtud-toosmall
www.stmik-time.ac.id	   pmtud-success
www.stmikdb.ac.id	   pmtud-success
www.stpbali.ac.id	   pmtud-success
www.sttgarut.ac.id	   pmtud-success
www.sttj.ac.id	   pmtud-fail
www.sttpln.ac.id	   pmtud-success
www.sunan-ampel.ac.id	   pmtud-success
www.tarumanagara.ac.id	   pmtud-toosmall
www.tep.ac.id	   pmtud-success
www.trisakti.ac.id	   pmtud-success
www.trunojoyo.ac.id	   pmtud-nodf
www.uad.ac.id	   pmtud-toosmall
www.uai.ac.id	   pmtud-toosmall
www.uajm.ac.id	   pmtud-success
www.uajy.ac.id	   pmtud-success
www.ub.ac.id	   pmtud-success
www.ubaya.ac.id	   pmtud-success
www.ubb.ac.id	   pmtud-fail
www.ubhara.ac.id	   pmtud-toosmall
www.ubharajaya.ac.id	   pmtud-toosmall
www.ubl.ac.id	   pmtud-success
www.ubm.ac.id	   pmtud-fail
www.ucy.ac.id	   pmtud-toosmall
www.uda.ac.id	   pmtud-success
www.udnas.ac.id	   pmtud-success
www.ugm.ac.id	   pmtud-success
www.ugp.ac.id	   pmtud-toosmall
www.ui.ac.id	   pmtud-fail
www.uib.ac.id	   pmtud-success
www.uid.ac.id	   pmtud-fail
www.uii.ac.id	   pmtud-success
www.uij.ac.id	   pmtud-toosmall
www.uika-bogor.ac.id	   pmtud-success
www.uim.ac.id	   pmtud-success
www.uimadura.ac.id	   pmtud-toosmall
www.uin-alauddin.ac.id	   pmtud-success
www.uin-malang.ac.id	   pmtud-fail
www.uin-suka.ac.id	   tcp-noconn
www.uinjkt.ac.id	   pmtud-success
www.uinsgd.ac.id	   pmtud-toosmall
www.uinsuska.info	   pmtud-toosmall
www.uir.ac.id	   pmtud-toosmall
www.uisu.ac.id	   pmtud-success
www.ukanjuruhan.ac.id	   pmtud-success
www.ukb.ac.id	   pmtud-toosmall
www.ukdw.ac.id	   pmtud-toosmall
www.uki.ac.id	   pmtud-toosmall
www.ukrida.ac.id	   pmtud-success
www.uks.ac.id	   pmtud-toosmall
www.uksw.edu	   pmtud-toosmall
www.um-surabaya.ac.id	   pmtud-success
www.um.ac.id	   pmtud-success
www.uma.ac.id	   pmtud-fail
www.umb.ac.id	   pmtud-toosmall
www.umc.ac.id	   pmtud-toosmall
www.umg.ac.id	   pmtud-success
www.umi.ac.id	   pmtud-toosmall
www.umj.ac.id	   pmtud-toosmall
www.umk.ac.id	   pmtud-success
www.umm.ac.id	   tcp-rst
www.ummetro.ac.id	   pmtud-toosmall
www.ummi.ac.id	   pmtud-success
www.ump.ac.id	   pmtud-nodf
www.umpalembang.ac.id	   pmtud-success
www.umpo.ac.id	   pmtud-success
www.umrah.ac.id	   pmtud-toosmall
www.ums.ac.id	   pmtud-success
www.umsb.ac.id	   pmtud-success
www.umsida.ac.id	   pmtud-toosmall
www.umsu.ac.id	   pmtud-success
www.umuslim.ac.id	   pmtud-success
www.umy.ac.id	   pmtud-success
www.unair.ac.id	   pmtud-success
www.unand.ac.id	   pmtud-success
www.unas.ac.id	   pmtud-fail
www.unb.ac.id	   pmtud-success
www.unbara.ac.id	   pmtud-fail
www.unbari.ac.id	   pmtud-success
www.unbrah.ac.id	   pmtud-success
www.uncend.ac.id	   pmtud-toosmall
www.unda.ac.id	   pmtud-toosmall
www.undana.ac.id	   tcp-noconn
www.undiknas.ac.id	   pmtud-success
www.undiksha.ac.id	   pmtud-success
www.undip.ac.id	   pmtud-success
www.unesa.ac.id	   pmtud-success
www.ung.ac.id	   tcp-noconn-rst
www.unhalu.ac.id	   pmtud-toosmall
www.unhas.ac.id	   tcp-noconn
www.uniat.ac.id	   pmtud-success
www.unib.ac.id	   pmtud-success
www.uniba-bpn.ac.id	   pmtud-toosmall
www.unida.ac.id	   pmtud-success
www.unidayan.ac.id	   pmtud-toosmall
www.uniga.ac.id	   tcp-noconn
www.unigamalang.ac.id	   pmtud-success
www.unik-kediri.ac.id	   pmtud-toosmall
www.unika.ac.id	   pmtud-success
www.unikal.ac.id	   pmtud-success
www.unikom.ac.id	   pmtud-toosmall
www.unila.ac.id	   pmtud-success
www.unilak.ac.id	   pmtud-success
www.unim.ac.id	   pmtud-toosmall
www.unima.ac.id	   tcp-rst
www.unimal.ac.id	   pmtud-success
www.unimas.ac.id	   pmtud-success
www.unimed.ac.id	   pmtud-success
www.unimedia.ac.id	   pmtud-success
www.unimmer.ac.id	   pmtud-success
www.unimus.ac.id	   pmtud-toosmall
www.unindra.ac.id	   pmtud-success
www.uninus.ac.id	   pmtud-success
www.unipa.ac.id	   pmtud-success
www.unipasby.ac.id	   pmtud-fail
www.unipdu.ac.id	   pmtud-fail
www.unisba.ac.id	   pmtud-success
www.unisbank.ac.id	   pmtud-success
www.unisda.ac.id	   pmtud-success
www.uniska-bjm.ac.id	   pmtud-success
www.unisla.ac.id	   pmtud-success
www.unisma.ac.id	   pmtud-fail
www.unismabekasi.ac.id	   pmtud-success
www.unismuh.ac.id	   pmtud-toosmall
www.unisri.ac.id	   pmtud-toosmall
www.unistangerang.ac.id	   pmtud-success
www.unitas-pdg.ac.id	   pmtud-success
www.unitomo.ac.id	   pmtud-success
www.unitri.ac.id	   pmtud-success
www.univ-ekasakti-pdg.ac.id	   pmtud-success
www.univ45.ac.id	   pmtud-success
www.univamedan.ac.id	   pmtud-toosmall
www.unived.ac.id	   pmtud-success
www.univpancasila.ac.id	   pmtud-success
www.univpgri-palembang.ac.id	   pmtud-success
www.unj.ac.id	   pmtud-toosmall
www.unja.ac.id	   pmtud-success
www.unjani.ac.id	   pmtud-toosmall
www.unklab.ac.id	   pmtud-toosmall
www.unkris.ac.id	   pmtud-success
www.unla.ac.id	   pmtud-success
www.unlam.ac.id	   pmtud-success
www.unm.ac.id	   pmtud-success
www.unmas.ac.id	   pmtud-success
www.unmer.ac.id	   pmtud-success
www.unmuhjember.ac.id	   pmtud-success
www.unmuhpnk.ac.id	   pmtud-toosmall
www.unmul.ac.id	   pmtud-success
www.unnes.ac.id	   pmtud-toosmall
www.unnur.ac.id	   pmtud-success
www.unp.ac.id	   pmtud-success
www.unpacti.ac.id	   pmtud-success
www.unpad.ac.id	   pmtud-success
www.unpak.ac.id	   pmtud-toosmall
www.unpam.ac.id	   pmtud-success
www.unpar.ac.id	   pmtud-success
www.unpas.ac.id	   pmtud-toosmall
www.unpatti.ac.id	   pmtud-toosmall
www.unpur.ac.id	   pmtud-toosmall
www.unram.ac.id	   pmtud-success
www.unri.ac.id	   pmtud-success
www.uns.ac.id	   pmtud-success
www.unsa.ac.id	   pmtud-toosmall
www.unsada.ac.id	   pmtud-success
www.unsam.ac.id	   pmtud-toosmall
www.unsil.ac.id	   pmtud-toosmall
www.unsiq.ac.id	   pmtud-success
www.unsoed.ac.id	   pmtud-success
www.unsrat.ac.id	   pmtud-success
www.unsri.ac.id	   pmtud-success
www.unsur.ac.id	   pmtud-toosmall
www.unsyiah.ac.id	   pmtud-success
www.untad.ac.id	   pmtud-success
www.untag-sby.ac.id	   pmtud-success
www.untagcirebon.ac.id	   pmtud-success
www.untagsmg.ac.id	   pmtud-fail
www.untan.ac.id	   pmtud-success
www.untirta.ac.id	   pmtud-success
www.unud.ac.id	   pmtud-toosmall
www.unwidha.ac.id	   pmtud-success
www.unwiku.ac.id	   pmtud-success
www.unwir.ac.id	   pmtud-toosmall
www.uny.ac.id	   pmtud-nodata
www.up45.ac.id	   pmtud-toosmall
www.upb.ac.id	   pmtud-success
www.upbatam.ac.id	   pmtud-success
www.uph.edu	   pmtud-success
www.uphsurabaya.ac.id	   pmtud-success
www.upi.edu	   pmtud-success
www.upnjatim.ac.id	   pmtud-success
www.upnvj.ac.id	   pmtud-success
www.upnyk.ac.id	   pmtud-toosmall
www.upr.ac.id	   pmtud-success
www.upstegal.ac.id	   pmtud-toosmall
www.upy.ac.id	   pmtud-toosmall
www.urindo.ac.id	   pmtud-success
www.usahid.ac.id	   pmtud-success
www.usbm.ac.id	   pmtud-success
www.usbypkp.ac.id	   pmtud-success
www.usd.ac.id	   pmtud-success
www.usni.ac.id	   pmtud-toosmall
www.ustjogja.ac.id	   pmtud-success
www.usu.ac.id	   pmtud-success
www.ut.ac.id	   pmtud-success
www.utira-ibek.ac.id	   pmtud-toosmall
www.utm.ac.id	   pmtud-success
www.utnd.ac.id	   pmtud-success
www.utp.ac.id	   pmtud-toosmall
www.uty.ac.id	   pmtud-success
www.uwks.ac.id	   pmtud-success
www.uwp.ac.id	   pmtud-toosmall
www.warmadewa.ac.id	   pmtud-success
www.web.usm.ac.id	   pmtud-toosmall
www.widyagama.ac.id	   pmtud-toosmall
www.widyakartika.ac.id	   pmtud-success
www.widyakarya.ac.id	   pmtud-success
www.widyamataram.ac.id	   pmtud-toosmall
www.widyatama.ac.id	   pmtud-success
www.wijayaputra.ac.id	   pmtud-success
www.wima.ac.id	   pmtud-success
www.wisnuwardhana.ac.id	   pmtud-success
www.yai.ac.id	   pmtud-success
www.yarsi.ac.id	   pmtud-success
www.yptk.ac.id	   pmtud-fail
www.yudharta.ac.id	   pmtud-toosmall
