IPv4/www.akakom.ac.id	 type: ecn, result: ecn-success
IPv4/www.akprind.ac.id	 type: ecn, result: ecn-incapable
IPv4/www.amikom.ac.id	 type: ecn, result: ecn-incapable
IPv4/www.asia.ac.id	 type: ecn, result: ecn-success
IPv4/www.asmi.ac.id	 type: ecn, result: ecn-incapable
IPv4/www.atmajaya.ac.id	 type: ecn, result: ecn-incapable
IPv4/www.bakrie.ac.id	 type: ecn, result: ecn-incapable
IPv4/www.binadarma.ac.id	 type: ecn, result: ecn-incapable
IPv4/www.binus.ac.id	 type: ecn, result: ecn-success
IPv4/www.borneo.ac.id	 type: ecn, result: tcp-noconn
IPv4/www.budiluhur.ac.id	 type: ecn, result: ecn-incapable
IPv4/www.bunghatta.ac.id	 type: ecn, result: ecn-incapable
IPv4/www.ciputra.ac.id	 type: ecn, result: ecn-incapable
IPv4/www.darmajaya.ac.id	 type: ecn, result: ecn-success
IPv4/www.dharmawangsa.ac.id	 type: ecn, result: ecn-incapable
IPv4/www.dinus.ac.id	 type: ecn, result: ecn-success
IPv4/www.eepis-its.edu	 type: ecn, result: ecn-incapable
IPv4/www.esaunggul.ac.id	 type: ecn, result: ecn-success
IPv4/www.fhwidyamataram.ac.id	 type: ecn, result: ecn-incapable
IPv4/www.ft-untirta.ac.id	 type: ecn, result: ecn-incapable
IPv4/www.gunadarma.ac.id	 type: ecn, result: ecn-incapable
IPv4/www.hangtuah.ac.id	 type: ecn, result: ecn-incapable
IPv4/www.iba.ac.id	 type: ecn, result: ecn-incapable
IPv4/www.ibii.ac.id	 type: ecn, result: ecn-incapable
IPv4/www.igm.ac.id	 type: ecn, result: tcp-noconn
IPv4/www.iisip.ac.id	 type: ecn, result: ecn-incapable
IPv4/www.ikj.ac.id	 type: ecn, result: ecn-incapable
IPv4/www.imtelkom.ac.id	 type: ecn, result: ecn-incapable
IPv4/www.ipb.ac.id	 type: ecn, result: ecn-success
IPv4/www.ipmimba.ac.id	 type: ecn, result: ecn-incapable
IPv4/www.isi-dps.ac.id	 type: ecn, result: ecn-incapable
IPv4/www.isi.ac.id	 type: ecn, result: ecn-success
IPv4/www.ista.ac.id	 type: ecn, result: ecn-incapable
IPv4/www.itb.ac.id	 type: ecn, result: ecn-incapable
IPv4/www.itenas.ac.id	 type: ecn, result: ecn-success
IPv4/www.ithb.ac.id	 type: ecn, result: ecn-incapable
IPv4/www.iti.ac.id	 type: ecn, result: ecn-incapable
IPv4/www.itm.ac.id	 type: ecn, result: ecn-success
IPv4/www.itn.ac.id	 type: ecn, result: ecn-success
IPv4/www.its.ac.id	 type: ecn, result: ecn-success
IPv4/www.ittelkom.ac.id	 type: ecn, result: ecn-incapable
IPv4/www.jagakarsa.ac.id	 type: ecn, result: ecn-incapable
IPv4/www.jak-stik.ac.id	 type: ecn, result: ecn-incapable
IPv4/www.janabadra.ac.id	 type: ecn, result: ecn-success
IPv4/www.jayabaya.ac.id	 type: ecn, result: ecn-incapable
IPv4/www.likmi.ac.id	 type: ecn, result: ecn-incapable
IPv4/www.lpp.ac.id	 type: ecn, result: ecn-incapable
IPv4/www.machung.ac.id	 type: ecn, result: ecn-incapable
IPv4/www.maranatha.edu	 type: ecn, result: ecn-success
IPv4/www.mercubuana-yogya.ac.id	 type: ecn, result: ecn-incapable
IPv4/www.mercubuana.ac.id	 type: ecn, result: ecn-incapable
IPv4/www.moestopo.ac.id	 type: ecn, result: ecn-incapable
IPv4/www.mputantular.ac.id	 type: ecn, result: ecn-incapable
IPv4/www.narotama.ac.id	 type: ecn, result: ecn-incapable
IPv4/www.nommensen.org	 type: ecn, result: ecn-incapable
IPv4/www.nusantara.ac.id	 type: ecn, result: ecn-success
IPv4/www.paramadina.ac.id	 type: ecn, result: ecn-incapable
IPv4/www.pasim.ac.id	 type: ecn, result: ecn-incapable
IPv4/www.perbanas.ac.id	 type: ecn, result: ecn-success
IPv4/www.perbanasinstitute.ac.id	 type: ecn, result: ecn-incapable
IPv4/www.petra.ac.id	 type: ecn, result: ecn-incapable
IPv4/www.pidel.org	 type: ecn, result: ecn-incapable
IPv4/www.pmbs.ac.id	 type: ecn, result: ecn-incapable
IPv4/www.pmy.ac.id	 type: ecn, result: ecn-incapable
IPv4/www.pnb.ac.id	 type: ecn, result: tcp-noconn
IPv4/www.pnl.ac.id	 type: ecn, result: ecn-incapable
IPv4/www.polban.ac.id	 type: ecn, result: ecn-success
IPv4/www.poliban.ac.id	 type: ecn, result: ecn-incapable
IPv4/www.polimdo.ac.id	 type: ecn, result: ecn-incapable
IPv4/www.polines.ac.id	 type: ecn, result: ecn-incapable
IPv4/www.polinpdg.ac.id	 type: ecn, result: ecn-incapable
IPv4/www.poliseni.ac.id	 type: ecn, result: ecn-incapable
IPv4/www.politekniktelkom.ac.id	 type: ecn, result: ecn-success
IPv4/www.poliupg.ac.id	 type: ecn, result: ecn-incapable
IPv4/www.polman-bandung.ac.id	 type: ecn, result: ecn-success
IPv4/www.polman-timah.ac.id	 type: ecn, result: ecn-incapable
IPv4/www.polnes.ac.id	 type: ecn, result: ecn-incapable
IPv4/www.polsri.ac.id	 type: ecn, result: ecn-incapable
IPv4/www.poltek-malang.ac.id	 type: ecn, result: ecn-success
IPv4/www.polteklampung.ac.id	 type: ecn, result: ecn-incapable
IPv4/www.poltekpos.ac.id	 type: ecn, result: ecn-success
IPv4/www.polteksurabaya.ac.id	 type: ecn, result: ecn-incapable
IPv4/www.ppm-manajemen.ac.id	 type: ecn, result: ecn-success
IPv4/www.president.ac.id	 type: ecn, result: ecn-success
IPv4/www.puterabatam.ac.id	 type: ecn, result: ecn-success
IPv4/www.respati.ac.id	 type: ecn, result: tcp-noconn-rst
IPv4/www.satyagama.ac.id	 type: ecn, result: ecn-incapable
IPv4/www.setiabudi.ac.id	 type: ecn, result: ecn-incapable
IPv4/www.sgu.ac.id	 type: ecn, result: ecn-incapable
IPv4/www.stie-mce.ac.id	 type: ecn, result: ecn-incapable
IPv4/www.stieken.ac.id	 type: ecn, result: ecn-incapable
IPv4/www.stieykpn.ac.id	 type: ecn, result: ecn-incapable
IPv4/www.stikesbanten.ac.id	 type: ecn, result: ecn-incapable
IPv4/www.stiki.ac.id	 type: ecn, result: ecn-incapable
IPv4/www.stikom-bali.ac.id	 type: ecn, result: ecn-incapable
IPv4/www.stikom.edu	 type: ecn, result: ecn-success
IPv4/www.stimra.ac.id	 type: ecn, result: ecn-incapable
IPv4/www.stmik-time.ac.id	 type: ecn, result: ecn-incapable
IPv4/www.stmikdb.ac.id	 type: ecn, result: ecn-incapable
IPv4/www.stpbali.ac.id	 type: ecn, result: ecn-incapable
IPv4/www.sttgarut.ac.id	 type: ecn, result: ecn-incapable
IPv4/www.sttj.ac.id	 type: ecn, result: ecn-incapable
IPv4/www.sttpln.ac.id	 type: ecn, result: ecn-incapable
IPv4/www.sunan-ampel.ac.id	 type: ecn, result: ecn-incapable
IPv4/www.tarumanagara.ac.id	 type: ecn, result: ecn-incapable
IPv4/www.tep.ac.id	 type: ecn, result: ecn-incapable
IPv4/www.trisakti.ac.id	 type: ecn, result: ecn-incapable
IPv4/www.trunojoyo.ac.id	 type: ecn, result: ecn-incapable
IPv4/www.uad.ac.id	 type: ecn, result: ecn-incapable
IPv4/www.uai.ac.id	 type: ecn, result: ecn-incapable
IPv4/www.uajm.ac.id	 type: ecn, result: ecn-incapable
IPv4/www.uajy.ac.id	 type: ecn, result: ecn-success
IPv4/www.ub.ac.id	 type: ecn, result: ecn-incapable
IPv4/www.ubaya.ac.id	 type: ecn, result: ecn-incapable
IPv4/www.ubb.ac.id	 type: ecn, result: ecn-incapable
IPv4/www.ubhara.ac.id	 type: ecn, result: ecn-incapable
IPv4/www.ubharajaya.ac.id	 type: ecn, result: ecn-incapable
IPv4/www.ubl.ac.id	 type: ecn, result: ecn-incapable
IPv4/www.ubm.ac.id	 type: ecn, result: ecn-incapable
IPv4/www.ucy.ac.id	 type: ecn, result: ecn-incapable
IPv4/www.uda.ac.id	 type: ecn, result: ecn-incapable
IPv4/www.udnas.ac.id	 type: ecn, result: ecn-incapable
IPv4/www.ugm.ac.id	 type: ecn, result: ecn-incapable
IPv4/www.ugp.ac.id	 type: ecn, result: ecn-incapable
IPv4/www.ui.ac.id	 type: ecn, result: ecn-incapable
IPv4/www.uib.ac.id	 type: ecn, result: ecn-incapable
IPv4/www.uid.ac.id	 type: ecn, result: ecn-incapable
IPv4/www.uii.ac.id	 type: ecn, result: ecn-incapable
IPv4/www.uij.ac.id	 type: ecn, result: ecn-incapable
IPv4/www.uika-bogor.ac.id	 type: ecn, result: ecn-incapable
IPv4/www.uim.ac.id	 type: ecn, result: ecn-incapable
IPv4/www.uimadura.ac.id	 type: ecn, result: ecn-incapable
IPv4/www.uin-alauddin.ac.id	 type: ecn, result: ecn-success
IPv4/www.uin-malang.ac.id	 type: ecn, result: ecn-success
IPv4/www.uin-suka.ac.id	 type: ecn, result: ecn-incapable
IPv4/www.uinjkt.ac.id	 type: ecn, result: tcp-noconn
IPv4/www.uinsgd.ac.id	 type: ecn, result: ecn-incapable
IPv4/www.uinsuska.info	 type: ecn, result: ecn-success
IPv4/www.uir.ac.id	 type: ecn, result: ecn-success
IPv4/www.uisu.ac.id	 type: ecn, result: ecn-incapable
IPv4/www.ukanjuruhan.ac.id	 type: ecn, result: ecn-incapable
IPv4/www.ukb.ac.id	 type: ecn, result: ecn-incapable
IPv4/www.ukdw.ac.id	 type: ecn, result: ecn-incapable
IPv4/www.uki.ac.id	 type: ecn, result: ecn-incapable
IPv4/www.ukrida.ac.id	 type: ecn, result: ecn-incapable
IPv4/www.uks.ac.id	 type: ecn, result: ecn-success
IPv4/www.uksw.edu	 type: ecn, result: ecn-incapable
IPv4/www.um-surabaya.ac.id	 type: ecn, result: ecn-success
IPv4/www.um.ac.id	 type: ecn, result: ecn-success
IPv4/www.uma.ac.id	 type: ecn, result: ecn-incapable
IPv4/www.umb.ac.id	 type: ecn, result: ecn-incapable
IPv4/www.umc.ac.id	 type: ecn, result: ecn-success
IPv4/www.umg.ac.id	 type: ecn, result: ecn-incapable
IPv4/www.umi.ac.id	 type: ecn, result: ecn-incapable
IPv4/www.umj.ac.id	 type: ecn, result: ecn-success
IPv4/www.umk.ac.id	 type: ecn, result: ecn-success
IPv4/www.umm.ac.id	 type: ecn, result: ecn-badsynack
IPv4/www.ummetro.ac.id	 type: ecn, result: ecn-incapable
IPv4/www.ummi.ac.id	 type: ecn, result: ecn-incapable
IPv4/www.ump.ac.id	 type: ecn, result: ecn-incapable
IPv4/www.umpalembang.ac.id	 type: ecn, result: ecn-incapable
IPv4/www.umpo.ac.id	 type: ecn, result: ecn-incapable
IPv4/www.umrah.ac.id	 type: ecn, result: ecn-incapable
IPv4/www.ums.ac.id	 type: ecn, result: ecn-incapable
IPv4/www.umsb.ac.id	 type: ecn, result: ecn-incapable
IPv4/www.umsida.ac.id	 type: ecn, result: ecn-success
IPv4/www.umsu.ac.id	 type: ecn, result: ecn-incapable
IPv4/www.umuslim.ac.id	 type: ecn, result: ecn-incapable
IPv4/www.umy.ac.id	 type: ecn, result: ecn-incapable
IPv4/www.unair.ac.id	 type: ecn, result: ecn-incapable
IPv4/www.unand.ac.id	 type: ecn, result: ecn-success
IPv4/www.unas.ac.id	 type: ecn, result: ecn-incapable
IPv4/www.unb.ac.id	 type: ecn, result: ecn-incapable
IPv4/www.unbara.ac.id	 type: ecn, result: ecn-incapable
IPv4/www.unbari.ac.id	 type: ecn, result: ecn-incapable
IPv4/www.unbrah.ac.id	 type: ecn, result: ecn-incapable
IPv4/www.uncend.ac.id	 type: ecn, result: ecn-incapable
IPv4/www.unda.ac.id	 type: ecn, result: ecn-incapable
IPv4/www.undana.ac.id	 type: ecn, result: tcp-noconn
IPv4/www.undiknas.ac.id	 type: ecn, result: ecn-success
IPv4/www.undiksha.ac.id	 type: ecn, result: ecn-success
IPv4/www.undip.ac.id	 type: ecn, result: ecn-incapable
IPv4/www.unesa.ac.id	 type: ecn, result: ecn-success
IPv4/www.ung.ac.id	 type: ecn, result: tcp-noconn-rst
IPv4/www.unhalu.ac.id	 type: ecn, result: ecn-incapable
IPv4/www.unhas.ac.id	 type: ecn, result: ecn-incapable
IPv4/www.uniat.ac.id	 type: ecn, result: ecn-incapable
IPv4/www.unib.ac.id	 type: ecn, result: ecn-incapable
IPv4/www.uniba-bpn.ac.id	 type: ecn, result: ecn-incapable
IPv4/www.unida.ac.id	 type: ecn, result: ecn-incapable
IPv4/www.unidayan.ac.id	 type: ecn, result: ecn-incapable
IPv4/www.uniga.ac.id	 type: ecn, result: tcp-noconn
IPv4/www.unigamalang.ac.id	 type: ecn, result: ecn-incapable
IPv4/www.unik-kediri.ac.id	 type: ecn, result: ecn-incapable
IPv4/www.unika.ac.id	 type: ecn, result: tcp-noconn
IPv4/www.unikal.ac.id	 type: ecn, result: ecn-success
IPv4/www.unikom.ac.id	 type: ecn, result: ecn-incapable
IPv4/www.unila.ac.id	 type: ecn, result: ecn-success
IPv4/www.unilak.ac.id	 type: ecn, result: ecn-incapable
IPv4/www.unim.ac.id	 type: ecn, result: ecn-success
IPv4/www.unima.ac.id	 type: ecn, result: ecn-badsynack
IPv4/www.unimal.ac.id	 type: ecn, result: ecn-incapable
IPv4/www.unimas.ac.id	 type: ecn, result: ecn-incapable
IPv4/www.unimed.ac.id	 type: ecn, result: ecn-incapable
IPv4/www.unimedia.ac.id	 type: ecn, result: ecn-incapable
IPv4/www.unimmer.ac.id	 type: ecn, result: ecn-incapable
IPv4/www.unimus.ac.id	 type: ecn, result: ecn-incapable
IPv4/www.unindra.ac.id	 type: ecn, result: ecn-incapable
IPv4/www.uninus.ac.id	 type: ecn, result: ecn-incapable
IPv4/www.unipa.ac.id	 type: ecn, result: ecn-incapable
IPv4/www.unipasby.ac.id	 type: ecn, result: ecn-success
IPv4/www.unipdu.ac.id	 type: ecn, result: ecn-incapable
IPv4/www.unisba.ac.id	 type: ecn, result: ecn-incapable
IPv4/www.unisbank.ac.id	 type: ecn, result: ecn-success
IPv4/www.unisda.ac.id	 type: ecn, result: ecn-incapable
IPv4/www.uniska-bjm.ac.id	 type: ecn, result: ecn-incapable
IPv4/www.unisla.ac.id	 type: ecn, result: ecn-incapable
IPv4/www.unisma.ac.id	 type: ecn, result: ecn-success
IPv4/www.unismabekasi.ac.id	 type: ecn, result: ecn-incapable
IPv4/www.unismuh.ac.id	 type: ecn, result: ecn-incapable
IPv4/www.unisri.ac.id	 type: ecn, result: ecn-incapable
IPv4/www.unistangerang.ac.id	 type: ecn, result: ecn-incapable
IPv4/www.unitas-pdg.ac.id	 type: ecn, result: ecn-incapable
IPv4/www.unitomo.ac.id	 type: ecn, result: ecn-incapable
IPv4/www.unitri.ac.id	 type: ecn, result: ecn-incapable
IPv4/www.univ-ekasakti-pdg.ac.id	 type: ecn, result: ecn-incapable
IPv4/www.univ45.ac.id	 type: ecn, result: ecn-incapable
IPv4/www.univamedan.ac.id	 type: ecn, result: ecn-incapable
IPv4/www.unived.ac.id	 type: ecn, result: ecn-incapable
IPv4/www.univpancasila.ac.id	 type: ecn, result: ecn-incapable
IPv4/www.univpgri-palembang.ac.id	 type: ecn, result: ecn-incapable
IPv4/www.unj.ac.id	 type: ecn, result: ecn-incapable
IPv4/www.unja.ac.id	 type: ecn, result: ecn-success
IPv4/www.unjani.ac.id	 type: ecn, result: ecn-incapable
IPv4/www.unklab.ac.id	 type: ecn, result: ecn-success
IPv4/www.unkris.ac.id	 type: ecn, result: ecn-incapable
IPv4/www.unla.ac.id	 type: ecn, result: ecn-incapable
IPv4/www.unlam.ac.id	 type: ecn, result: ecn-incapable
IPv4/www.unm.ac.id	 type: ecn, result: ecn-incapable
IPv4/www.unmas.ac.id	 type: ecn, result: ecn-incapable
IPv4/www.unmer.ac.id	 type: ecn, result: ecn-incapable
IPv4/www.unmuhjember.ac.id	 type: ecn, result: ecn-success
IPv4/www.unmuhpnk.ac.id	 type: ecn, result: ecn-incapable
IPv4/www.unmul.ac.id	 type: ecn, result: ecn-success
IPv4/www.unnes.ac.id	 type: ecn, result: ecn-success
IPv4/www.unnur.ac.id	 type: ecn, result: ecn-incapable
IPv4/www.unp.ac.id	 type: ecn, result: ecn-incapable
IPv4/www.unpacti.ac.id	 type: ecn, result: ecn-incapable
IPv4/www.unpad.ac.id	 type: ecn, result: ecn-success
IPv4/www.unpak.ac.id	 type: ecn, result: ecn-incapable
IPv4/www.unpam.ac.id	 type: ecn, result: ecn-incapable
IPv4/www.unpar.ac.id	 type: ecn, result: ecn-incapable
IPv4/www.unpas.ac.id	 type: ecn, result: ecn-success
IPv4/www.unpatti.ac.id	 type: ecn, result: ecn-incapable
IPv4/www.unpur.ac.id	 type: ecn, result: ecn-incapable
IPv4/www.unram.ac.id	 type: ecn, result: ecn-success
IPv4/www.unri.ac.id	 type: ecn, result: ecn-incapable
IPv4/www.uns.ac.id	 type: ecn, result: ecn-incapable
IPv4/www.unsa.ac.id	 type: ecn, result: ecn-incapable
IPv4/www.unsada.ac.id	 type: ecn, result: ecn-success
IPv4/www.unsam.ac.id	 type: ecn, result: ecn-incapable
IPv4/www.unsil.ac.id	 type: ecn, result: ecn-incapable
IPv4/www.unsiq.ac.id	 type: ecn, result: ecn-incapable
IPv4/www.unsoed.ac.id	 type: ecn, result: ecn-incapable
IPv4/www.unsrat.ac.id	 type: ecn, result: ecn-incapable
IPv4/www.unsri.ac.id	 type: ecn, result: ecn-incapable
IPv4/www.unsur.ac.id	 type: ecn, result: ecn-incapable
IPv4/www.unsyiah.ac.id	 type: ecn, result: ecn-incapable
IPv4/www.untad.ac.id	 type: ecn, result: ecn-success
IPv4/www.untag-sby.ac.id	 type: ecn, result: ecn-success
IPv4/www.untagcirebon.ac.id	 type: ecn, result: ecn-incapable
IPv4/www.untagsmg.ac.id	 type: ecn, result: ecn-incapable
IPv4/www.untan.ac.id	 type: ecn, result: ecn-incapable
IPv4/www.untirta.ac.id	 type: ecn, result: ecn-incapable
IPv4/www.unud.ac.id	 type: ecn, result: ecn-incapable
IPv4/www.unwidha.ac.id	 type: ecn, result: ecn-success
IPv4/www.unwiku.ac.id	 type: ecn, result: ecn-incapable
IPv4/www.unwir.ac.id	 type: ecn, result: ecn-incapable
IPv4/www.uny.ac.id	 type: ecn, result: ecn-incapable
IPv4/www.up45.ac.id	 type: ecn, result: ecn-incapable
IPv4/www.upb.ac.id	 type: ecn, result: ecn-incapable
IPv4/www.upbatam.ac.id	 type: ecn, result: ecn-success
IPv4/www.uph.edu	 type: ecn, result: ecn-incapable
IPv4/www.uphsurabaya.ac.id	 type: ecn, result: ecn-incapable
IPv4/www.upi.edu	 type: ecn, result: ecn-success
IPv4/www.upnjatim.ac.id	 type: ecn, result: ecn-incapable
IPv4/www.upnvj.ac.id	 type: ecn, result: ecn-success
IPv4/www.upnyk.ac.id	 type: ecn, result: ecn-incapable
IPv4/www.upr.ac.id	 type: ecn, result: ecn-incapable
IPv4/www.upstegal.ac.id	 type: ecn, result: ecn-incapable
IPv4/www.upy.ac.id	 type: ecn, result: ecn-success
IPv4/www.urindo.ac.id	 type: ecn, result: ecn-incapable
IPv4/www.usahid.ac.id	 type: ecn, result: ecn-incapable
IPv4/www.usbm.ac.id	 type: ecn, result: ecn-incapable
IPv4/www.usbypkp.ac.id	 type: ecn, result: ecn-incapable
IPv4/www.usd.ac.id	 type: ecn, result: ecn-incapable
IPv4/www.usni.ac.id	 type: ecn, result: ecn-incapable
IPv4/www.ustjogja.ac.id	 type: ecn, result: ecn-incapable
IPv4/www.usu.ac.id	 type: ecn, result: ecn-success
IPv4/www.ut.ac.id	 type: ecn, result: ecn-incapable
IPv4/www.utira-ibek.ac.id	 type: ecn, result: ecn-incapable
IPv4/www.utm.ac.id	 type: ecn, result: ecn-incapable
IPv4/www.utnd.ac.id	 type: ecn, result: ecn-incapable
IPv4/www.utp.ac.id	 type: ecn, result: ecn-incapable
IPv4/www.uty.ac.id	 type: ecn, result: ecn-incapable
IPv4/www.uwks.ac.id	 type: ecn, result: ecn-incapable
IPv4/www.uwp.ac.id	 type: ecn, result: ecn-incapable
IPv4/www.warmadewa.ac.id	 type: ecn, result: ecn-success
IPv4/www.web.usm.ac.id	 type: ecn, result: ecn-incapable
IPv4/www.widyagama.ac.id	 type: ecn, result: ecn-success
IPv4/www.widyakartika.ac.id	 type: ecn, result: ecn-success
IPv4/www.widyakarya.ac.id	 type: ecn, result: ecn-incapable
IPv4/www.widyamataram.ac.id	 type: ecn, result: ecn-incapable
IPv4/www.widyatama.ac.id	 type: ecn, result: ecn-incapable
IPv4/www.wijayaputra.ac.id	 type: ecn, result: ecn-incapable
IPv4/www.wima.ac.id	 type: ecn, result: ecn-success
IPv4/www.wisnuwardhana.ac.id	 type: ecn, result: ecn-incapable
IPv4/www.yai.ac.id	 type: ecn, result: ecn-incapable
IPv4/www.yarsi.ac.id	 type: ecn, result: ecn-incapable
IPv4/www.yptk.ac.id	 type: ecn, result: ecn-incapable
IPv4/www.yudharta.ac.id	 type: ecn, result: ecn-success
